**XXXXXXXXXXXXXXXXXXXXXXXXXXXXXXXXXXXXXXXXXXXXXXXXXXXXXXXXXXXXXXXXXXXXXXXXXXXXXXXXXXXXXXXXXXXXXXXXXX
X***********X*X***X*X*********X*******X*********X*****X***X*********X***X*****X*****X*******X******X
XXX*XXXXX*XXX*X*XXX*X*XXXXX*X*XXXXX*X*X*XXX*XXXXX*X*XXXXX*XXXXX*XXXXX*X*X*XXX*XXX*XXXXX*XXX*X*X*XXXX
X*****X***X*X***********X*X*X***X***X*X***X*****X*X***X***X***X*******X*X***X*X*****X***X***X*X****X
X*X*X*XXXXX*XXX*X*X*X*XXX*X*X*X*X*XXX*X*XXX*XXXXX*X*XXXXX*X*XXX*XXXXX*X*XXXXX*XXXXX*XXXXX*XXXXX*XXXX
X*X*X*X*X***X*X*X*X*X*****X*X*X***X***X***X*****X*X*X*******X*****X***X*X*******X*X*****X*****X*X**X
X*XXXXX*XXX*X*X*X*XXXXX*XXX*X*XXX*XXXXX*XXX*XXX*XXX*XXX*X*X*XXX*XXX*X*XXX*XXXXX*X*X*X*XXX*X*XXX*X*XX
X***********X***X*****X***X*X***X*X***X*X***X***X*****X*X*X*X***X***X*X*******X*****X*****X*X******X
X*XXXXX*XXX*XXXXX*XXX*XXX*XXX*X*XXX*XXX*X*X*XXXXX*X*X*XXX*XXX*XXXXX*XXX*X*XXXXX*XXXXX*XXX*X*XXX*XXXX
X*X***X***X*****X*X***X*****X*X*********X*X*******X*X*****X*X***X***X*X*X*X*****X***X***X*X********X
X*XXX*XXX*X*XXX*XXXXX*X*XXXXX*XXXXX*XXX*X*XXX*X*XXXXX*XXX*X*XXXXX*X*X*XXX*XXX*XXXXX*XXX*XXX*X*XXX*XX
X*X*******X*X*****X***X***X***X*X***X***X*X***X*X*X***X***X*X*****X*******X*****X***X*****X*X*X****X
X*X*X*XXX*XXXXX*X*XXX*X*XXXXX*X*X*XXX*X*XXXXX*XXX*X*X*X*XXX*XXXXX*X*XXX*XXXXX*XXX*X*XXX*XXX*X*XXX*XX
X*X*X***X*X***X*X*X*X*X*X***X*X***X***X*X*****X*X***X*X***X*******X*X*****X*****X*X*X*****X*X***X**X
X*X*XXX*XXX*X*XXX*X*XXXXX*X*XXX*X*X*X*X*XXX*XXX*XXXXX*X*XXX*X*XXX*XXXXX*XXX*X*XXXXX*XXX*XXXXX*X*X*XX
X*X*X*****X*X*X*******X***X*X***X*X*X*X*X***X*X***X***X*X***X***X***X*****X*X***X*******X***X*X*X**X
X*X*XXXXX*X*X*XXX*X*XXX*X*X*X*X*XXX*X*XXX*X*X*XXX*X*X*XXX*XXX*XXX*X*X*XXX*XXX*XXX*X*XXX*X*X*XXX*XXXX
X*X*X***X***X*X***X*****X*X*X*X*X***X***X*X***X*X***X*X*****X***X*X*X***X*X*****X*X***X*X*X*X******X
X*X*XXX*X*XXX*XXX*XXXXX*X*X*X*X*XXX*X*X*XXXXX*X*XXX*X*X*XXX*X*XXXXX*XXX*XXXXX*X*XXXXX*X*XXX*XXX*XXXX
X*X*****X*X***X*X***X***X*X***X*X***X*X*****X***X***X*****X*X*X***X*X*****X***X***X*X*X*******X****X
X*XXXXX*XXX*XXX*X*XXX*X*XXXXX*XXX*XXXXX*XXX*XXXXX*XXX*XXX*X*XXX*XXX*XXX*XXXXX*XXX*X*X*XXX*XXXXX*XXXX
X*****X***X***X*****X*X*****X***X*X***X***X*X***X*X*****X*X*****X*****X***X*****X***X***X***X*X****X
XXX*XXX*XXX*X*XXXXX*X*XXX*XXXXX*XXX*X*X*X*X*XXX*X*XXXXX*XXXXX*XXX*X*X*X*X*XXXXX*X*X*X*X*XXX*X*XXX*XX
X*****X*X***X*****X*X***X*****X*X***X***X*X***X*X***X***X***X*X***X*X*X*X*X*****X*X*X*X*X***X***X**X
X*XXX*X*XXXXX*XXX*XXX*XXX*X*X*X*XXX*XXX*XXXXX*X*X*XXXXX*XXX*X*XXXXX*X*X*X*XXX*XXXXX*XXX*X*XXX*XXX*XX
X***X*X***X*X***X***X***X*X*X*X*X*****X***X*X***X*X*****X*********X*X*X*X*X***X*****X***X*****X****X
XXX*X*X*XXX*X*XXXXX*XXX*XXX*XXX*XXX*XXXXX*X*XXXXX*XXX*XXX*XXXXX*XXX*XXXXX*XXXXX*XXXXX*X*X*XXXXX*X*XX
X*X*X*X*****X***X*****X*X***X*X***X*X*****X*****X***X***X*X*****X*****X*X***X*****X***X*X***X***X**X
X*X*XXX*X*X*XXX*XXX*XXX*X*X*X*XXXXX*XXX*XXXXX*X*X*XXXXX*XXX*X*XXXXX*XXX*X*X*X*X*XXX*XXXXX*X*XXXXX*XX
X***X***X*X*X*****X*X***X*X*******X***X*****X*X*****X*X***X*X*X***X***X***X*X*X***X*****X*X***X****X
X*XXX*XXX*XXX*XXX*XXX*X*XXX*XXX*XXX*X*XXXXX*XXXXX*XXX*XXXXX*XXX*XXXXX*XXX*XXX*XXXXX*XXX*XXXXX*XXX*XX
X***X*X***X*X***X*X***X***X*X***X*X*X*X*********X***X***X*X***X*X***X***X*X*****X*****X*****X*X****X
X*XXX*XXXXX*XXX*X*XXX*XXXXX*XXXXX*XXXXX*XXX*X*XXX*X*X*X*X*XXXXX*X*X*X*XXXXX*X*XXXXX*XXX*XXX*X*XXX*XX
X*X*X*****X***X*X*X*X*****X*X***X*X***X*X***X*X***X*X*X***********X*X***X***X***X***X*X***X*X***X**X
X*X*X*X*XXX*XXX*XXX*X*XXXXX*X*XXX*X*X*XXX*X*X*X*XXXXX*XXX*XXXXX*XXXXX*XXX*XXXXX*XXXXX*X*XXXXX*XXX*XX
X***X*X***X***X*X***X*X*******X*****X***X*X*X*X***X*X***X*****X*********X*X***X*****X***X*X***X****X
XXX*X*XXX*X*XXXXX*X*XXXXX*X*X*XXX*X*X*XXX*X*XXX*X*X*X*X*X*X*X*XXX*XXXXX*XXXXX*X*XXX*X*XXX*XXX*XXX*XX
X***X*X*********X*X*X***X*X*X*X***X*X*****X*X***X*X***X*X*X*X*X***X***X***X*X***X***X*X***X*****X**X
X*XXXXX*XXXXX*XXX*X*X*XXXXX*XXX*XXX*X*XXX*XXX*X*XXX*XXXXX*XXXXX*XXXXX*X*XXX*X*XXX*X*XXXXX*X*X*X*XXXX
X*****X*****X***X*X***********X*X***X***X***X*X*X*******X*X***X***X*******X*****X*X***X*X***X*X****X
X*XXXXX*X*XXX*X*X*XXX*X*XXX*XXXXX*X*XXX*XXXXX*XXX*X*X*XXXXX*XXXXX*XXX*X*XXXXX*X*XXX*X*X*XXX*X*XXX*XX
X***X*X*X***X*X*X***X*X*X*******X*X*X*******X*X***X*X*****X*******X*X*X*****X*X***X*X*X*****X*X****X
X*XXX*X*X*XXX*XXX*XXX*XXX*X*X*XXXXX*XXXXX*X*X*XXX*XXXXX*X*XXX*XXX*X*X*X*XXX*XXX*X*X*XXXXX*X*XXX*X*XX
X*X*X***X*X***X***X*****X*X*X*****X*X*****X*X***X***X***X***X***X*X***X***X*X***X*X***X***X*X***X**X
XXX*X*XXXXX*XXX*X*XXXXX*XXX*X*X*X*XXX*XXX*X*XXX*XXXXX*XXX*XXX*X*XXXXX*XXX*X*XXXXX*XXX*X*XXXXX*XXX*XX
X*X*X*****X***X*X*X*X***X*X*X*X*X***X*X***X*X*X*****X*X*****X*X*X*X***X***X*X***X*X***X***X*X***X**X
X*X*X*X*XXX*XXXXX*X*XXX*X*X*X*XXX*XXX*X*XXXXX*X*XXX*X*X*XXX*X*XXX*X*X*XXXXX*XXX*XXXXX*X*XXX*XXXXX*XX
X*****X***X*****X*X***X***X*X***X*X***X*X*****X***X*X*X*X***X*X***X*X***X*******X*****X*X*****X****X
XXX*X*XXXXX*XXXXX*X*XXX*XXX*X*XXX*XXXXX*X*X*X*XXXXX*XXXXX*XXXXX*XXXXX*XXX*XXX*X*XXX*XXXXX*X*XXX*X*XX
X*X*X*****X*****X*X***X*X***X*X***X*X*****X*X*X*******X*******X*X***X***X*X***X***X*****X*X*X***X**X
X*XXX*XXXXX*XXXXX*X*XXX*XXX*XXXXX*X*X*XXX*XXX*XXX*XXX*XXXXX*XXX*XXX*XXXXX*XXXXX*XXXXX*XXX*XXX*XXXXXX
X*******X***X*******X*****X*****X*X*X***X*X*****X***X*X***X*X***X*****X*****X***X***X*X*********X**X
X*XXX*XXXXX*XXXXX*X*XXXXX*XXX*X*XXX*X*XXXXX*XXXXX*XXX*XXX*XXX*X*XXXXX*X*XXX*XXXXX*XXX*X*X*XXX*X*X*XX
X*X***X***X*X*****X*X*****X***X*****X***X*X*****X***X*****X***X*X*X***X***X*****X*****X*X***X*X****X
XXXXX*XXX*X*XXX*XXX*X*XXX*X*XXXXX*XXXXX*X*XXX*XXXXX*XXXXX*XXX*X*X*XXX*XXXXX*X*XXX*X*XXXXX*X*X*XXX*XX
X*X***X***X*X***X***X*X***X*X***X*X*******X***X***X*****X***X*X*******X***X*X***X*X***X*X*X*X***X**X
X*XXXXX*X*XXX*X*X*XXX*X*XXX*X*X*X*XXX*XXX*XXXXX*XXX*XXXXX*X*XXXXX*XXXXX*XXX*X*XXXXX*XXX*XXX*X*XXX*XX
X*******X*X***X*X***X*X*X***X*X***X*****X*X*X***X*X***X***X***X***X*X*****X*X*X***X*X***X***X***X**X
X*XXXXX*X*X*XXXXX*XXX*XXXXX*XXX*XXXXX*XXXXX*X*X*X*XXX*X*X*XXXXX*XXX*X*X*X*XXX*X*XXX*XXX*XXXXX*X*XXXX
X***X***X***X*****X***X***X***X*X*******X***X*X*******X*X*********X***X*X***X*****X***X*X***X*X****X
XXX*X*XXX*XXXXX*X*XXX*XXX*X*XXX*XXXXX*XXX*XXXXX*X*XXX*XXXXX*XXX*X*XXX*XXXXX*XXXXX*XXXXX*XXX*X*X*XXXX
X***X***X*****X*X***X*X***X*X***X***X***X*X*****X*X***X*****X***X***X***X***X*****X***X*******X****X
XXX*XXXXX*X*X*XXX*X*XXXXX*XXX*X*X*X*XXXXX*XXXXX*XXX*XXX*X*XXXXX*X*XXX*XXX*X*XXX*XXXXX*X*XXX*X*X*X*XX
X*****X***X*X***X*X*****X***X*X***X*X***X*X***X***X***X*X***X*X*X***X***X*X***X*****X*****X*X*X*X**X
X*XXXXX*XXXXX*XXXXX*XXXXX*XXX*XXX*XXX*XXX*X*X*XXXXX*X*X*XXXXX*X*X*XXX*X*XXXXX*XXXXX*X*X*XXX*XXX*X*XX
X*****X*X*******X*****X*X***X*X*************X*****X*X*X*******X*X***X*X*X*****X*X***X*X***X*X***X**X
X*X*X*X*XXXXX*X*XXXXX*X*X*XXX*X*XXX*X*XXXXX*XXXXX*X*XXXXX*XXX*XXXXX*X*X*XXX*XXX*XXX*XXX*XXX*X*X*XXXX
X*X*X*X*X***X*X*****X***X***X*X***X*X*****X*X***X*X*****X*X*****X*****X***X***X*X***X*****X*X*X****X
X*XXX*X*X*XXX*XXXXX*XXXXX*X*XXX*XXXXX*XXXXX*X*XXX*X*X*X*XXX*X*X*X*X*X*XXX*XXXXX*X*XXX*X*XXXXX*XXX*XX
X***X*X*****X***X*X*******X***X*X***X***X*X***X***X*X*X***X*X*X*X*X*X*X*****X***X*X***X*X*X*****X**X
X*XXXXX*XXXXX*XXX*X*X*X*X*XXX*XXXXX*X*XXX*X*X*XXX*X*XXXXX*X*X*XXXXX*X*X*XXX*X*X*XXXXX*XXX*X*X*XXX*XX
X*****X*****X*X*****X*X*X***X***X***X*****X*X***X*X***X*X*X*X*X*****X*X***X***X*X***X*X***X*X***X**X
XXX*X*XXX*XXX*X*X*XXXXX*X*XXX*X*XXX*XXX*X*XXXXX*X*XXXXX*X*X*XXXXX*X*XXX*XXXXX*XXX*X*XXX*XXXXX*X*XXXX
X***X***X*X***X*X***X*X*X*X***X*X***X*X*X*X***X*X*****X***X*X*X***X***X***X***X***X*X***X*****X****X
XXX*XXX*XXXXX*XXX*XXX*XXX*X*X*X*XXX*X*XXXXX*X*X*XXX*X*XXXXX*X*X*XXXXX*XXXXX*X*X*XXX*XXX*X*XXX*XXX*XX
X*****X*****X*X***X*X*****X*X*X***X***X*X***X*X***X*X*****X***X*****X*****X*X*X***X*****X***X***X**X
X*XXXXX*X*XXX*XXXXX*X*XXXXX*XXX*XXX*X*X*XXXXX*X*XXX*X*XXX*XXX*XXXXX*XXXXX*XXXXX*XXX*X*X*X*XXX*XXXXXX
X***X***X*X*****X*******X***X*X***X*X***X*X***X*X***X*X*****X*X***X***X***X*X*****X*X*X*X***X******X
XXX*X*X*XXX*XXX*XXX*XXXXX*X*X*XXX*X*XXXXX*XXX*X*X*XXX*XXXXX*X*XXX*X*X*XXX*X*X*X*XXX*XXXXX*X*XXXXX*XX
X***X*X*X*X***X*X***X***X*X***X***X***X*****X***X*X***X*X***X*X***X*X***X*X***X*X***X*****X*X*X****X
X*XXX*XXX*X*XXXXX*XXX*XXX*XXX*XXX*X*X*XXX*X*XXX*XXXXX*X*XXX*XXXXX*X*X*X*XXX*XXXXX*XXX*X*X*XXX*XXX*XX
X***X***X***X*X*******X***X***X*****X*****X*X***X***X*****X***X*X***X*X*X***X*****X***X*X***X***X**X
XXXXX*XXXXX*X*XXXXX*XXXXX*XXXXX*XXX*XXX*X*XXX*XXX*X*X*XXX*XXXXX*XXXXX*XXXXX*XXXXX*XXX*X*X*XXX*XXX*XX
X***X***X*X*******X*X*******X*****X***X*X***X*X***X*X***X***X*******X***X***X***X*X***X*X*****X****X
XXX*X*XXX*XXX*XXXXX*XXXXX*XXX*X*XXX*XXXXX*XXX*XXX*XXX*XXXXX*XXXXX*X*XXX*XXX*X*X*XXX*XXXXX*XXX*XXXXXX
X***X***X***X*****X***X***X*X*X*X*****X*****X***X***X***X***X*****X*X***X***X*X*X*X*****X*X********X
X*XXXXX*X*X*XXXXX*XXXXX*XXX*XXX*XXXXX*XXX*X*XXX*XXX*XXXXX*XXX*X*XXXXX*X*X*XXX*XXX*XXXXX*XXXXX*X*XXXX
X***X*****X*X***X*****X*****X*******X***X*X***X*****X*****X***X*****X*X***X*X***********X***X*X****X
X*XXXXX*X*XXXXX*XXX*XXXXX*XXX*X*XXXXX*XXXXX*X*X*X*XXX*XXX*X*XXX*XXXXX*X*XXX*X*XXX*XXXXX*XXX*X*XXX*XX
X*X***X*X***X*****X***X***X***X***X*****X***X*X*X***X*X***X*X***X*****X*X*******X*****X*****X*X****X
X*X*XXX*XXX*XXX*XXX*X*XXX*XXX*X*XXXXX*X*XXXXX*XXX*X*X*X*XXXXX*X*X*X*XXX*XXX*X*XXX*X*XXX*XXXXX*X*XXXX
X*****X***X***X***X*X***X*X***X***X***X*X***X*X***X*X*X***X***X*X*X*X***X***X***X*X***X*X*****X*X**X
XXX*XXXXX*X*XXXXX*XXXXX*XXX*XXX*XXXXX*XXX*X*XXX*XXX*XXX*X*XXXXX*X*XXX*X*XXX*XXX*XXXXX*XXX*X*XXX*X*XX
X*******X*X*******X*******X*X***X***X*X***X*X*****X*X***X*****X***X*X*X*X***X***X*****X***X*X******X
X*XXXXX*XXXXX*XXXXX*XXX*XXX*X*XXX*XXXXX*XXXXX*X*XXX*XXXXX*XXX*X*XXX*X*XXX*XXX*X*XXX*X*XXX*X*XXXXX*XX
X*X***X*******X***X*X***X***X***************X*X***X*X***X***X*X***X*****X*X***X*X***X***X*X*****X**X
XXX*X*X*XXX*X*X*X*XXXXX*XXX*XXX*X*XXX*X*X*XXXXX*XXX*XXX*XXX*X*XXX*XXX*XXX*XXX*XXXXX*XXX*X*XXX*XXX*XX
X***X***X***X***X***X*****X***X*X***X*X*X***X*****X*****X***X*X*****X***X***X***X***X***X***X*X*****
X*X*X*X*X*X*X*X*X*X*X*X*X*X*X*X*X*X*X*X*X*X*X*X*X*X*X*X*X*X*X*X*X*X*X*X*X*X*X*X*X*X*X*X*X*X*X*X*X*X*
XXXXXXXXXXXXXXXXXXXXXXXXXXXXXXXXXXXXXXXXXXXXXXXXXXXXXXXXXXXXXXXXXXXXXXXXXXXXXXXXXXXXXXXXXXXXXXXXXXX*
